NCR = "countries/NCR - New California Republic.txt"
YMP = "countries/YMP - Yampa.txt"
RAP = "countries/RAP - The Rapids.txt"
RUB = "countries/RUB - Ruby Valley Refuge.txt"
GDH = "countries/GDH - Gente.txt"
ISN = "countries/ISN - Issaquah Nation.txt"
EHT = "countries/EHT - Eighties.txt"
PHA = "countries/PHA - Pharohs.txt"
PMR = "countries/PMR - Port Maw.txt"
DES = "countries/DES - Desert Rangers.txt"
BLA = "countries/BLA - Black Crook.txt"
RIP = "countries/RIP - Riperult Territory.txt"
CES = "countries/CES - Caesar's Legion.txt"
UIN = "countries/UIN - Uintah.txt"
THO = "countries/THO - Mount Thorn.txt"
BRK = "countries/BRK - Broken Coast.txt"
VIC = "countries/VIC - New Victoria.txt"
HGH = "countries/HGH - High Chapel.txt"
DEA = "countries/DEA - Dead Horses.txt"
UMB = "countries/UMB - Umbra.txt"
FRI = "countries/FRI - Frisco City.txt"
CRZ = "countries/CRZ - Crazy Horns.txt"
HIN = "countries/HIN - Hinterlands.txt"
BEL = "countries/BEL - Bellingham.txt"
VIP = "countries/VIP - Vipers.txt"
TUR = "countries/TUR - Turtlerock.txt"
TOC = "countries/TOC - The Old Country.txt"
YKZ = "countries/YKZ - Yakuza Territory.txt"
SHO = "countries/SHO - Shoshone Nation.txt"
BOS = "countries/BOS - Brotherhood.txt"
HAI = "countries/HAI - Haida Confederation.txt"
PNT = "countries/PNT - Painted Men.txt"
MOJ = "countries/MOJ - Mojave Chapter.txt"
BDT = "countries/BDT - Bone Dancer.txt"
GRA = "countries/GRA - Grabber Territory.txt"
EAS = "countries/EAS - Eastport.txt"
HOP = "countries/HOP - Hopeville.txt"
TLO = "countries/TLO - Tierra.txt"
SKY = "countries/SKY - Sky Reavers.txt"
MLT = "countries/MLT - Mirelurk Tribe.txt"
RED = "countries/RED - Red Canyon.txt"
COW = "countries/COW - Cowboy Country.txt"
KLA = "countries/KLA - Klameth.txt"
SOR = "countries/SOR - Sorrows.txt"
LGS = "countries/LGS - Las Granjas.txt"
DRE = "countries/DRE - Dredgers.txt"
TCA = "countries/TCA - The Cause.txt"
HAM = "countries/HAM - New Hammond.txt"
HAN = "countries/HAN - Hangdogs.txt"
VEG = "countries/VEG - Vegas.txt"
BPT = "countries/BPT - Bone Picker.txt"
NEW = "countries/NEW - New Reno.txt"
ARR = "countries/ARR - Arroyo.txt"
WBH = "countries/WBH - Washington Brotherhood.txt"
YAK = "countries/YAK - Yakama Nation.txt"
RBD = "countries/RBD - Baudelio Ranchers.txt"
WHT = "countries/WHT - White Legs.txt"
FOR = "countries/FOR - Foragers.txt"
IRN = "countries/IRN - IronAlliance.txt"
TWI = "countries/TWI - Twisted Hairs.txt"
SCO = "countries/SCO - Scorpions Bite.txt"
CHE = "countries/CHE - Chemult Station.txt"
MDT = "countries/MDT - Marrow Drinkers.txt"
SHI = "countries/SHI - Shi.txt"
NAV = "countries/NAV - Navajo Nation.txt"
LON = "countries/LON - Lonetree.txt"
TAR = "countries/TAR - Tar Walkers.txt"
SCP = "countries/SCP - Scorpions.txt"
MRA = "countries/MRA - Mojave Raiders.txt"
VLT = "countries/VLT - Vault City.txt"
ZDW = "countries/ZDW - Zuihou.txt"
NCN = "countries/NCN - New Canaanites.txt"
MUR = "countries/MUR - Murtaugh.txt"
TOB = "countries/TOB - The Old Bones.txt"
IRE = "countries/IRE - Ires.txt"
TWO = "countries/TWO - Two Sun.txt"
NBM = "countries/NBM - New Battle Mountain.txt"
BLP = "countries/BLP - Paz Bandits.txt"
FIE = "countries/FIE - The Fiends.txt"
CLI = "countries/CLI - Clitton.txt"
ASH = "countries/ASH - Ashton.txt"
RBT = "countries/RBT - Rib Breakers.txt"
TRL = "countries/TRL - Troll Warren.txt"
ANT = "countries/ANT - Antelope Tribe.txt"
TTM = "countries/TTM - Twin Mothers.txt"
PAL = "countries/PAL - Pale Folk.txt"
JAC = "countries/JAC - Jackles.txt"
PEC = "countries/PEC - Pecos Colony.txt"
DEL = "countries/DEL - Delta.txt"
BVC = "countries/BVC - Valle Bandits.txt"
DAM = "countries/DAM - Dam Busters.txt"
TON = "countries/TON - Tohono Nation.txt"
CYC = "countries/CYC - Cyclops Tribe.txt"
KHA = "countries/KHA - Great Khans.txt"
BMT = "countries/BMT - Battle Tribe.txt"
CHY = "countries/CHY - Cheyenne.txt"
LOS = "countries/LOS - Los.txt"
NAM = "countries/NAM - Nampa.txt"
NCS = "countries/NCS - NCR Salvagers.txt"
ORG = "countries/ORG - Oregon Cannibals.txt"
ORI = "countries/ORI - Orophin.txt"
POW = "countries/POW - Powder Gangers.txt"
RID = "countries/RID - Ridgers.txt"
RPD = "countries/RPD - Rapids.txt"
RST = "countries/RST - Rust Tribe.txt"
RVR = "countries/RVR - Ruby Raiders.txt"
SPR = "countries/SPR - Springers.txt"
TOI = "countries/TOI - Toiyabe Tribe.txt"
YEL = "countries/YEL - Yellowstone.txt"
ZIP = "countries/ZIP - Zip Mountain.txt"
